SO textures/SO.txt
C     225,30,51
WE textures/WE.txt
EA textures/EA.txt

F 220,100,40   
               
      	NO textures/NO.txt

1111111111         
10N1100001
1111111111