SO textures/map/SO.png
C     225,30,51
WE textures/map/WE.png
EA textures/map/EA.png

F 220,100,40   
               
      	NO textures/map/NO.png

1111111111         
1001100001
1001100001
1000000S01
1111111111