SO textures/map/SO.png
C     184,184,209   
WE textures/map/WE.png
EA textures/map/EA.png

F 57,61,63  


      	NO textures/map/NO.png





1111
1N01
1001
1111
