SO textures/SO.txt
C     225,30,51
WE textures/WE.txt
EA textures/EA.txt

F 220,100,40   


      	NO textures/NO.txt
      	NO textures/NO.txt





        1111111111111111111111111           
        1000000000110000000000001
        1011000001110000000000001  1
        1001000000100000000000001
111111111111111111110000000000111
100000000011000001110111111111111
11110111111111011100000010001
11110111111111011101010010001
11000000110101001100000010001
10000000000000001100000010001
11100000000000001101010010001
  100001110101011111011110N01
11110111 1110101 101111010001
11111111 1111111 111111111111
