SO textures/map/SO.png
C     184,184,209   
WE textures/map/WE.png
EA textures/map/EA.png

F 57,61,63  


      	NO textures/map/NO.png





        1111111111111111111111111   
        1000000000110000000000001
        1011000001110000000000001
        10010000000000000000000011111111111111
1111111111111111111100000000000000000000000001  1
10000000001100000111001111111111111111111111111
11110111111111011100000010001
11110111111111011101010010001
11000000110101000000000010001
10000000000000000000000000001
11100000000000001101010000001
  100001110101011111011100N01
11110111 1110101 101111010001
11111111 1111111 111111111111
