SO textures/map/SO.png
C     184,184,209   
WE textures/map/WE.png
EA textures/map/EA.png

F 57,61,63  


      	NO textures/map/NO.png

1111111111111111111111111111111111111111111111111111111111111111
1000000000000000000000000000000000000000000000000000000000000001
1000000000001000000000000000000000000010000000000000000000000001
1000000000000000000000000000000000000000000000000000000000000001
1000000000000000000000000000100000000000000000000000000000000001
1000000000000000000000000000000000000000000000000000000000000001
1000000000000000000000000001000000000010000000000000000000000001
1000000000000000000000000000000000000000000000000000000000000001
1000000000000000000000000000000000000000000000000000000000000001
1000000000000000000000000010000000000000000000000000000000000001
1000001000000000000000000000000000100000000000000000000000000001
1000000000000000000000000000000000000000000000000000000000000001
1000000000000000000000000000000000000000000000000000000000000001
10000000000000000000000000000E0000000000000000000000000000000011
1000000000000000000000000000000000000000000000000000000000000001
100000000000000000000000000000000000000000000000000000000000000111111111111111111111111111111111
100000000000000000000000000000000000000000000000000000000000001000000000000000000000000000000011
100000000000100000000000000000000010000000000000000000000000000100000000000000000000000000000001
100000000000000000000000000000000000000000000000000000000000000000000000000000000000000000000001
100000000000000000000000000000000000000000000000000000000000000000000000000000000000000000000001
100000000000000000000000000000000000000000000000000000000000000100000000000000000000000000000001
100000100000000000000000000000000000001000000000000000000000000111111111111111111111111111111111
1111111111111111111111111111111111111111111111111111111111111111